F                                       153,153,102                  


WE               ./assets/textures/wall_textures/tile118.png

C 51,51,153


NO ./assets/textures/wall_textures/tile066.png
SO               ./assets/textures/wall_textures/tile106.png 
        EA       ./assets/textures/wall_textures/tile120.png




1111111111111111111111111
1000000000110000000000001
1011000001110000000000001 
10010000000000000000000011111111111111111111111111
1001000000000000000000000
1011000000100000000000001 
10000000010100      00001
1001000000100000000000001
10110000011100N0000000001
1000000000110000000000001
1001000000000000000000001
1011000001110000000000001
1000000000110000000000001
1000000000000000000000001
1111111111111111111111111



