1111111111111111111111111
2000000000550000000000003
2055000005550000000000003
2005000000000000000000003
2005000000000000000000003
2055000000500000000000003
2000000005050000000000003
2005000000500000000000003
2055000005550000000000003
2000000000550000000000003
200500N000000000000000003
2055000005550000000000003
2000000000550000000000003
2000000000000000000000003
1444444444444444444444441
